WWWWWWWWWWWWWWWWWWWWWWWWWWW
W.........................W
W.........................W
W.........................W
W.........................W
W......W..........W.......W
W......W..........W.......W
W......W..........W.......W
W.........................W
W.........................W
W.........................W
W.........................W
WWWWWWWWWWWWWWWWWWWWWWWWWWW